1111111111111
1000000000C11
10000111110C1
1E0110CP00011
1111111111111
