1111111111111
1000000000C11
11000111110C1
101E10CP00011
1111111111111
