1111111111111111111111111111111111
1E000000000C0000000000000000000001
1010101010101010101010101010101011
1000100010001000100010001000100011
1010101010101010101010101010101011
10000000000000000000000000000000P1
1111111111111111111111111111111111
