1111111111111111111111111
1P00000000000000111110001
1110111111111100010001001
100010000001110001C010001
101110111101000001C011001
1010000001010111010101001
101011111101000001010C001
1010000011001111010111011
101011101C000000000000001
1010001011111111011111111
1011101000000000000000001
1000001111111111111111E11
1111111111111111111111111
