111111111111111
1E0000000000001
1111111111110C1
11111111111C001
111111111100001
111111111P00C01
100000C0000C001
111111111111111
