11111111111
1C000000001
10111111101
10100000001
10101111101
10101111101
10101111101
101C00010C1
10100100011
10100000001
10000000001
10000000101
10010000001
100000100C1
11100000111
1E100000C01
101000001P1
11111111111
